##########
#@.......#
#.X......#
#........#
#........#
#........#
#........#
#......$.#
#........#
##########