##########
#@......X#
#.X..#...#
#..#.....#
#.....#..#
#........#
#.#..#...#
#.$....$.#
#.#......#
##########