##########
#........#
#.####...#
#.#X.#...#
#.#.$...#
#.#..#...#
#....#$X.#
#@...#...#
#....#...#
##########
