##########
#....#...#
#.X$@$X..#
#..#.#...#
#........#
#..###...#
#........#
#........#
#........#
##########
