##########
#..X.....#
#.$......#
#..###...#
#..#.#...#
#.@$X....#
#..#.....#
#........#
#........#
##########
