##########
#.X......#
#.$#.....#
#..#$....#
#..#X...#
#...#....#
#.@......#
#........#
#........#
##########
