##########
#......X.#
#.##.#.#.#
#.$..#.#.#
#.##.#...#
#.#..#.#.#
#.$..#.X.#
#@#.....#
#........#
##########
