##########
#X.....X.#
#.#.##.#.#
#.$....$.#
#.#....#.#
#.$....$.#
#.#.##.#.#
#X.....X.#
#...@....#
##########
