##########
#........#
#.X#X#X..#
#..$.$...#
#..#.#...#
#..$.....#
#..#.#...#
#.X......#
#@.......#
##########
