##########
#........#
#.###.##.#
#.X.$....#
#.#..#.#.#
#....$X..#
#.#.#..#.#
#.X.$....#
#.....@..#
##########
