#######
#.X...#
#.@...#
#.$...#
#.....#
#######
