########
#......#
#.X.X..#
#..$...#
#.@....#
#.$.$..#
#..X...#
########
