########
#......#
#.X.X..#
#.@....#
#.$.$..#
#......#
########
